6,12,4,6,10,10,14,14,10,8,6,12
5,7,13,7,10,10,13,3,14,14,9,5
5,5,5,5,4,6,11,14,9,7,8,5
7,9,3,9,7,11,14,9,6,15,10,9
5,4,6,12,7,10,9,6,13,5,6,12
7,15,13,5,5,6,14,13,7,13,5,5
5,5,7,13,5,3,9,3,13,7,9,5
5,7,9,3,15,10,12,2,15,9,2,13
5,3,10,12,3,14,11,12,7,10,10,13
7,14,10,13,6,15,12,5,1,6,12,5
5,5,6,9,5,5,7,13,4,5,5,5
1,3,11,10,9,3,9,3,11,11,11,9
